abandonment	su bo, su tu bo, su bo roi, su ruong bo

abbreviate	tom tat, viet tat; rut ngan lai (cuoc di tham...)

abbreviation	su tom tat, su rut ngan (cuoc di tham...)

abdominal	(thuoc) bung; o bung

abide	ton tai; keo dai

ability	nang luc, kha nang (lam viec gi)

able	co nang luc, co tai

banana	chuoi

bean	dau

beer	bia

bicycle	xe dap

big	to, lon

billionaire	(tu My,nghia My) nha ti phu

binary	doi, nhi nguyen, nhi phan

bye-bye	tam biet

bygone	qua khu, qua roi, cu ky

cat	con meo

catch	su bat, su nam lay; cai bat, cai vo, cai chop

centimeter	xentimet

centre	diem giua, tam; trung tam; trung khu; trung uong

century	tram nam, the ky

certified	duoc chung nhan, duoc nhan thuc, duoc chung thuc

chair	ghe

change	su doi, su thay doi, su bien doi

charity	long nhan duc, long tu thien; long thao

deserve	dang, xung dang

design	de cuong, ban phac thao, phac hoa, do an

develop	trinh bay, bay to, thuyet minh (luan diem, van de...)

diagram	bieu do

diamond	kim cuong

different	khac, khac biet, khac nhau

digit	chu so

eruption	su phun (nui lua)

expansion	su mo rong, su banh truong, su phat trien, su phong ra; phan mo rong

finish	su ket thuc, su ket liễu; phan cuoi, phan ket thuc, doan ket thuc

fire	lua, anh lua

footprint	dau chan, vet chan

fruit	trai cay

full	day, day dủ, nhieu, tran tre, tran ngap, chan chua

grace	ve duyen dang, ve yeu kieu; ve uyen chuyen

guardian	nguoi bao ve

hack	bua, riu; cuoc chim (cua cong nhan mo)

here	day, o day, o chỗ nay

inch	in xo

incoming	su vao, su den

inconsiderate	thieu an can, thieu chu dao, thieu quan tam

incorporate	ket hop chat che

inequality	su khong bang nhau; su khong binh dang

introspective	hay tu xem xet noi tam; hay noi quan

invisibility	tinh khong the trong thay duoc, tinh vo hinh

joy	su vui mung, su han hoan, su vui suong

juice	nuoc ep trai cay

ketchup	nuoc xot ca chua

monkey	khi

smoothies	sinh to

tea	tra

wine	ruou

