ability	/əˈbɪlɪti/

area	/ˈeərɪə/

art	/ɑːt/

bai	a

banana	/bə'nɑ:nə/

computer	/kəmˈpjuːtə/

dd	d

family	/ˈfæmɪli/

fire	/'faiə[r]/

government	/ˈgʌvnmənt/

health	/hɛlθ/

hello	/həˈləu/ 

history	/ˈhɪstəri/

j	j

law	/lɔː/

love	/lʌv/

map	/mӕp/

quality	/ˈkwɒlɪti/

s	s

video	/ˈvɪdɪəʊ/

á	s

